111111111111111111111111
1E0000000000X00000000001
101001010010000000010101
101001001010000000010101
1P0000000C000000000000C1
111111111111111111111111
