11111111111111111111111111111111111111111
1E1000000000000C10000C0000000000000000001
10000101001000011010010000000101000000001
10100100101010100010010000000101000000001
10100101001000001010010000000101000000001
100000000C00C0000000000000000000C00000001
100000000C00C0000000000000000000C00000001
100000000C00C0000000000000000000C00000001
100000000C00C0000000000000000000C00000001
10100101001000001010010000000101000000001
10100101001000001010010000000101000000001
10100101001000001010P10000000101000000001
10100101001000001010010000000101000000001
10100100101010100010010000000101000000001
100000000C00C0000000000000000000C00000001
100000000C00C0000000000000000000C00000001
100000000C00C0000000000000000000C00000001
100000000C00C0000000000000000000C00000001
100000000C00C0000000000000000000C00000001
100000000C00C0000000000000000000C00000001
100000000C00C0000000000000000000C00000001
100000000C00C0000000000000000000C00000001
100000000C00C0000000000000000000C00000001
11111111111111111111111111111111111111111
