1111111111111111111111111111111111
1E1000000000000C10000C000000000001
1000010100100001101001000000010101
1010010010101010001001000000010101
1010010100100000101001000000010101
1010010100100000101001000000010101
1010010100100000101001000000010101
100000000C00C0000000000000000000C1
100000000C00C0000000000000000000C1
10100101001000001P1001000000010101
100000000C00C0000000000000000000C1
1010010100100000101001000000010101
1010010010101010001001000000010101
100000000C00C0000000000000000000C1
100000000C00C0000000000000000000C1
100000000C00C0000000000000000000C1
100000000C00C0000000000000000000C1
100000000C00C0000000000000000000C1
100000000C00C0000000000000000000C1
1111111111111111111111111111111111
