1111111111111111111111111111111111
1E0000000000000C00000C000000001111
1010010100100000001000000000010101
1010010010101010001000000000010101
1P0000000C00C000000000000000001111
1111111111111111111111111111111
