11111111111111111111111
1E00C00000C000000000001
10100101001000000010101
1010000100100P000010101
100000000000000000000C1
11111111111111111111111
